-1 -1 -1 -1 -1 -1 -1 -1 -1 -1 -1 -1 -1 -1 -1 -1 -1 -1 -1 -1 -1 -1 -1 -1 -1 -1 -1 -1 -1 -1 -1 -1 -1 -1 -1 -1 -1 -1 -1 -1 -1 -1 -1 -1 -1 -1 -1 -1 -1 -1 -1 -1 -1 -1 -1 -1 -1 -1 -1 -1 -1 -1 -1 -1 -1 -1 -1 -1 -1 -1 -1 -1 -1 -1 -1 -1 -1 -1 -1 -1 -1 -1 -1 -1 -1 -1 -1 -1 -1 -1 -1 -1 -1 -1 -1 -1 -1 -1 -1 -1 -1 -1 -1 -1 -1 -1 -1 -1 -1 -1 -1 -1 -1 -1 -1 -1 -1 -1 -1 -1 -1 -1 -1 -1 -1 -1 -1 -1 -1 -1 -1 -1 -1 -1 -1 -1 -1 -1 -1 -1 -1 -1 -1 -1 -1 -1 -1 -1 -1 -1 -1 -1 -1 -1 -1 -1 -1 -1 -1 -1 -1 -1 -1 -1 -1 -1 -1 -1 -1 -1 -1 -1 -1 -1 -1 -1 -1 -1 -1 -1 -1 -1 -1 -1 -1 -1 -1 -1 -1 -1 -1 -1 -1 -1 -1 -1 -1 -1 -1 -1 -1 -1 -1 -1 -1 -1 -1 -1 -1 -1 -1 -1 -1 -1 -1 -1 -1 -1 -1 -1 -1 -1 -1 -1 -1 -1 -1 -1 -1 -1 -1 -1 -1 -1 -1 -1 -1 -1 -1 -1 -1 -1 -1 -1 -1 -1 -1 -1 -1 -1 -1 -1 -1 -1 -1 -1 -1 -1 -1 -1 -1 -1 -1 -1 -1 -1 -1 -1 -1 -1 -1 -1 -1 -1 -1 -1 -1 -1 -1 -1 -1 -1 -1 -1 -1 -1 -1 -1 -1 -1 -1 -1 -1 -1 -1 -1 -1 -1 -1 -1
-1 -1 -1 -1 -1 -1 -1 -1 -1 -1 -1 -1 -1 -1 -1 -1 -1 -1 -1 -1 -1 -1 -1 -1 -1 -1 -1 -1 -1 -1 -1 -1 -1 -1 -1 -1 -1 -1 -1 -1 -1 -1 -1 -1 -1 -1 -1 -1 -1 -1 -1 -1 -1 -1 -1 -1 -1 -1 -1 -1 -1 -1 -1 -1 -1 -1 -1 -1 -1 -1 -1 -1 -1 -1 -1 -1 -1 -1 -1 -1 -1 -1 -1 -1 -1 -1 -1 -1 -1 -1 -1 -1 -1 -1 -1 -1 -1 -1 -1 -1 -1 -1 -1 -1 -1 -1 -1 -1 -1 -1 -1 -1 -1 -1 -1 -1 -1 -1 -1 -1 -1 -1 -1 -1 -1 -1 -1 -1 -1 -1 -1 -1 -1 -1 -1 -1 -1 -1 -1 -1 -1 -1 -1 -1 -1 -1 -1 -1 -1 -1 -1 -1 -1 -1 -1 -1 -1 -1 -1 -1 -1 -1 -1 -1 -1 -1 -1 -1 -1 -1 -1 -1 -1 -1 4 0 2 -1 4 0 0 0 0 0 2 -1 -1 -1 -1 4 2 -1 -1 -1 -1 -1 -1 -1 -1 -1 -1 -1 -1 -1 -1 -1 -1 -1 -1 -1 -1 -1 -1 -1 -1 -1 -1 -1 -1 -1 -1 -1 -1 -1 -1 -1 -1 -1 -1 -1 -1 -1 -1 -1 -1 -1 -1 -1 -1 -1 -1 -1 -1 -1 -1 -1 -1 -1 -1 -1 -1 -1 -1 -1 -1 -1 -1 -1 -1 -1 -1 -1 -1 -1 -1 -1 -1 -1 -1 -1 -1 -1 -1 -1 -1 -1 -1 -1 -1 -1 -1 -1 -1 -1 -1 -1 -1 -1 -1 -1 -1 -1 -1 -1 -1 -1 -1 -1 -1 -1
-1 -1 -1 -1 -1 -1 -1 -1 -1 -1 -1 -1 -1 -1 -1 -1 -1 -1 -1 -1 -1 -1 -1 -1 -1 -1 -1 -1 -1 -1 -1 -1 -1 -1 -1 -1 -1 -1 -1 -1 -1 -1 -1 -1 -1 -1 -1 -1 -1 -1 -1 -1 -1 -1 -1 -1 -1 -1 -1 -1 -1 -1 -1 -1 -1 -1 -1 -1 -1 -1 -1 -1 -1 -1 4 2 -1 -1 -1 -1 -1 -1 -1 -1 -1 -1 -1 -1 -1 -1 -1 -1 -1 -1 -1 -1 4 0 2 -1 -1 -1 -1 -1 -1 -1 -1 -1 -1 -1 -1 -1 -1 -1 -1 -1 -1 -1 -1 -1 -1 -1 4 2 -1 -1 4 0 0 0 2 -1 -1 -1 -1 -1 -1 -1 -1 -1 -1 -1 -1 -1 -1 -1 -1 -1 -1 -1 -1 -1 -1 -1 -1 -1 -1 -1 -1 -1 -1 -1 -1 -1 -1 -1 -1 -1 -1 -1 4 0 2 -1 4 0 2 -1 -1 3 4 0 2 5 -1 -1 -1 -1 -1 4 2 -1 -1 -1 -1 -1 -1 -1 -1 -1 -1 -1 -1 -1 -1 -1 -1 -1 -1 -1 -1 -1 -1 3 3 3 3 3 5 -1 -1 -1 -1 -1 -1 -1 -1 -1 -1 -1 -1 -1 -1 4 0 2 -1 -1 -1 -1 -1 -1 -1 -1 -1 -1 -1 -1 -1 -1 -1 -1 4 0 0 2 -1 -1 -1 -1 -1 -1 -1 -1 -1 -1 -1 -1 -1 -1 -1 -1 -1 -1 -1 -1 -1 -1 -1 -1 -1 -1 -1 -1 -1 -1 -1 -1 -1 -1 -1 -1 -1 -1 -1 -1 -1 -1 -1 -1
-1 -1 -1 -1 -1 -1 -1 -1 -1 -1 -1 -1 -1 -1 -1 -1 -1 -1 -1 -1 -1 -1 -1 -1 -1 -1 -1 -1 -1 -1 -1 -1 -1 -1 -1 -1 -1 -1 -1 -1 -1 -1 -1 -1 -1 -1 -1 -1 -1 -1 -1 -1 -1 -1 -1 -1 -1 -1 -1 -1 -1 -1 -1 -1 -1 -1 -1 -1 -1 -1 -1 -1 -1 -1 4 2 -1 -1 -1 -1 -1 -1 -1 -1 -1 -1 -1 -1 -1 -1 -1 -1 -1 -1 -1 -1 -1 5 -1 -1 -1 -1 -1 -1 -1 -1 -1 -1 -1 -1 -1 -1 -1 -1 -1 4 0 0 2 -1 -1 -1 4 2 -1 -1 3 -1 -1 -1 5 -1 4 0 0 0 0 0 2 -1 -1 -1 -1 -1 -1 -1 -1 4 0 2 4 0 2 -1 -1 -1 -1 -1 -1 -1 -1 -1 -1 -1 -1 -1 4 0 2 -1 4 0 2 -1 3 -1 5 -1 -1 3 5 1 3 5 -1 -1 -1 -1 -1 4 2 -1 -1 -1 -1 -1 -1 -1 -1 -1 -1 -1 -1 -1 -1 -1 -1 -1 -1 3 3 3 3 4 0 0 0 2 5 -1 -1 -1 -1 -1 -1 -1 -1 -1 -1 4 0 2 -1 -1 5 -1 -1 -1 -1 -1 -1 -1 -1 -1 -1 -1 -1 -1 -1 -1 -1 -1 4 0 0 2 -1 -1 -1 -1 -1 -1 -1 -1 -1 -1 -1 -1 4 0 0 0 0 0 0 0 0 0 0 0 0 0 0 2 -1 -1 -1 -1 -1 -1 -1 -1 -1 -1 -1 -1 -1 -1 -1 -1
-1 -1 -1 -1 -1 -1 -1 -1 -1 -1 -1 -1 -1 -1 -1 4 0 0 0 2 -1 -1 4 2 -1 -1 -1 -1 -1 -1 -1 -1 -1 -1 4 0 2 -1 -1 -1 -1 -1 -1 -1 -1 -1 4 0 2 -1 -1 -1 4 0 0 2 -1 4 0 2 -1 4 0 0 2 -1 -1 -1 -1 -1 4 2 -1 -1 3 5 -1 -1 4 2 -1 -1 -1 -1 -1 -1 -1 -1 -1 -1 -1 4 0 2 -1 -1 -1 3 -1 -1 4 0 2 -1 -1 -1 -1 -1 -1 -1 -1 -1 -1 -1 -1 4 0 0 0 0 0 0 0 2 -1 -1 4 2 -1 4 2 -1 3 -1 -1 1 -1 -1 5 -1 -1 -1 -1 -1 -1 -1 -1 4 0 2 4 0 2 -1 -1 -1 -1 -1 -1 -1 -1 4 0 0 2 -1 4 0 2 -1 3 -1 5 -1 3 -1 5 -1 -1 3 5 1 3 5 -1 -1 -1 -1 -1 4 2 -1 -1 -1 -1 -1 -1 -1 -1 -1 -1 -1 -1 -1 -1 3 3 3 3 4 0 0 0 0 0 0 0 2 5 -1 -1 -1 -1 -1 -1 -1 -1 -1 -1 4 0 2 -1 -1 3 -1 -1 4 0 2 -1 -1 -1 -1 -1 -1 -1 -1 -1 -1 -1 -1 -1 -1 -1 -1 -1 -1 -1 -1 -1 -1 -1 -1 -1 -1 -1 -1 3 -1 -1 -1 -1 -1 -1 -1 -1 -1 -1 -1 -1 -1 -1 5 -1 -1 -1 -1 -1 -1 -1 -1 -1 -1 -1 -1 -1 -1 -1 -1
-1 -1 -1 -1 -1 -1 -1 -1 -1 -1 -1 -1 -1 -1 -1 5 4 0 2 5 -1 -1 4 2 -1 -1 4 0 0 0 0 2 -1 -1 3 1 5 -1 4 0 0 0 0 0 2 -1 3 1 5 -1 -1 -1 3 1 1 5 -1 3 1 5 -1 3 1 1 5 -1 -1 -1 -1 -1 4 2 -1 -1 3 5 -1 -1 4 2 -1 -1 -1 -1 -1 -1 -1 -1 -1 -1 -1 -1 3 -1 -1 -1 -1 5 -1 -1 -1 5 -1 -1 -1 -1 -1 -1 -1 -1 -1 -1 4 0 0 0 0 0 2 3 -1 -1 -1 5 -1 -1 4 0 0 0 2 -1 4 0 2 -1 4 0 2 -1 -1 -1 -1 -1 -1 -1 -1 4 0 0 0 0 2 -1 -1 -1 -1 -1 -1 -1 -1 4 0 0 2 -1 3 -1 5 -1 3 -1 5 -1 3 -1 5 -1 -1 3 5 1 3 5 -1 -1 -1 -1 -1 4 2 -1 -1 -1 -1 -1 -1 -1 -1 -1 3 3 3 3 3 4 0 0 0 0 0 0 0 0 0 0 0 2 5 -1 -1 -1 -1 -1 -1 -1 -1 -1 -1 -1 5 -1 -1 -1 3 -1 -1 -1 5 -1 -1 -1 -1 -1 -1 -1 -1 -1 -1 4 2 -1 -1 -1 -1 -1 -1 -1 -1 -1 -1 -1 -1 -1 -1 -1 -1 -1 3 -1 -1 -1 -1 -1 -1 -1 -1 -1 -1 -1 -1 -1 -1 5 -1 -1 -1 -1 -1 -1 -1 -1 -1 -1 -1 -1 -1 -1 -1 -1
0 0 0 0 0 0 0 0 0 0 0 0 2 -1 -1 5 4 0 2 5 -1 -1 4 2 -1 -1 3 1 1 1 1 4 0 0 2 1 5 -1 3 -1 -1 -1 -1 -1 5 -1 3 1 5 -1 -1 -1 3 1 1 5 -1 3 1 5 -1 3 1 1 5 -1 -1 4 2 -1 3 5 -1 -1 3 5 -1 -1 3 5 -1 -1 4 2 -1 -1 4 0 2 -1 -1 -1 5 -1 -1 -1 -1 5 -1 -1 -1 3 -1 -1 -1 -1 4 0 0 0 0 2 4 0 0 2 -1 -1 -1 3 -1 -1 -1 5 -1 -1 4 2 -1 4 2 -1 4 0 2 -1 4 0 2 -1 -1 -1 -1 4 0 2 -1 3 -1 1 1 -1 5 -1 4 0 0 0 0 0 0 2 3 -1 5 -1 3 -1 5 -1 3 -1 5 -1 3 -1 5 -1 -1 3 5 1 3 5 -1 -1 -1 -1 -1 4 0 0 0 0 0 0 0 0 0 0 0 0 0 0 0 0 0 0 0 0 0 0 0 0 0 0 0 0 2 -1 -1 -1 -1 -1 4 0 0 2 -1 -1 3 -1 -1 -1 3 -1 -1 -1 3 -1 -1 4 2 -1 -1 -1 -1 -1 -1 -1 -1 -1 -1 -1 -1 -1 -1 -1 -1 -1 -1 4 0 0 0 0 2 -1 3 -1 -1 -1 -1 -1 -1 -1 -1 -1 -1 -1 -1 -1 -1 5 -1 -1 4 0 0 0 0 0 0 0 0 0 0 0 0 0
1 1 1 -1 1 -1 1 -1 1 -1 1 -1 1 -1 -1 4 0 0 0 2 -1 -1 4 2 -1 -1 3 1 1 1 1 1 1 1 1 1 5 -1 3 -1 -1 -1 -1 -1 5 -1 3 1 5 -1 -1 -1 3 1 1 5 -1 3 1 5 -1 3 1 1 5 -1 -1 4 2 -1 3 5 -1 -1 3 5 -1 -1 3 5 -1 -1 4 2 -1 -1 -1 3 -1 -1 -1 -1 3 -1 -1 -1 -1 3 -1 -1 -1 5 -1 -1 -1 -1 3 1 1 1 1 5 4 0 0 2 -1 -1 -1 3 -1 -1 -1 5 -1 -1 3 -1 -1 -1 5 -1 3 -1 -1 1 -1 -1 5 -1 -1 -1 -1 4 0 2 -1 3 -1 1 1 -1 5 -1 3 1 -1 1 1 -1 1 -1 3 -1 5 -1 3 -1 5 -1 3 -1 5 -1 3 -1 5 -1 -1 3 4 0 2 5 -1 -1 -1 -1 -1 3 1 1 1 1 1 1 1 1 1 1 1 1 1 1 1 1 1 1 1 1 1 1 1 1 1 1 1 1 5 -1 -1 -1 -1 -1 -1 4 2 -1 -1 -1 5 -1 -1 -1 5 -1 -1 -1 5 -1 -1 4 2 -1 -1 4 0 2 -1 -1 -1 -1 -1 -1 -1 -1 -1 -1 -1 -1 -1 3 1 5 3 1 5 -1 3 -1 -1 -1 -1 -1 -1 -1 -1 -1 -1 -1 -1 -1 -1 5 -1 -1 3 -1 1 -1 1 -1 1 -1 1 -1 1 1 1 1
